11111111100000000000000000000000000000000000000000000000000000000000000000000000000000000000000000000000000000000000000000000000000
11111111110000000000000000000000000000000000000000000000000000000000000000000000000000000000000000000000000000000000000000000000001
11111111111000000000000000000000000000000000000000000000000000000000000000000000000000000000000000000000000000000000000000000000011
11111111111100000000000000000000000000000000000000000000000000000000000000000000000000000000000000000000000000000000000000000001111
11111111111100000000000000000000000000000000000000000000000000000000000000000000000000000000000000000000000000000000000000000000111
11111111111111100000000000000000000000000000000000000000000000000000000000000000000000000000000000000000000000000000000000000111111
11111111111111110000000000000000000000000000000000000000000000000000000000000000000000000000000000000000000000000000000001111111111
11111111111111110000000000000000000000000000000000000000000000000000000111111111111111111100000000000000000000001111111111111111111
11111111111110000000000000000000000000000000000000000000000000000000011111111111111111111111100000011111111111111111111111111111111
11111111111100000000000000000000000000000000000000000000000000000001111111111111111111111111111000111111111111111111111111111111111
11111111111000000000000000000000000000000000000000000000000000000001111111111111110000001111111110111111111111111111111111111111111
11111111110000000000000000000000000000000000000000000000000000000001111111100000000000001111111111111111111111111111111111111111111
11111111110000000000000000000000000000000000000000000000000000000011111111100000000000001111111111111111111111111111111111111111111
11111111111000000000000000000000000000000000000000000000000000000111111111100000000000001111111111111111111111111111111111111111111
11111111110000000000000000000000000000000000000000000000000001111111111111100000000000000000000000000011111111111111111111111111111
11111111111000000000000000000000000000000000000000000000000001111111111111100000000000000000000000000000000001111111111111111111111
11100000000000000000000000000000000000000000000000000000000000111111111111100000000000000000000000000000000000000000000001111111111
11111100000000000000000000000000000000000000000000000000000000011111111000000000000000000000000000000000000000000000000000011111111
11111000000000000000000000000000000000000000000000000000000000000000000000000000000011110000000000000000000000000000000111111111111
11111110000000000000001111100000000000000000000000000000000000000000000000000000000111111000000000000000000000000000000000001111111
11100000000000000000011111111111100000000000000000000011000000000000000000000000001111111111111100000000000000000000000000000000111
11100000000000000000111111111111000000000000000000000111100000000000000000000000011111111111111111111111111000000000000000000011111
11110000000000011111111111111111000000000000000000001111110000000000000000000001111111111111111111111111111000000000000000011111111
11110000000000000000000000000000000000000000111111111111111111110000000000001111111111111111111111111111100000000000000001111111111
11111100000000001000000000000000000000000000111111111111111111111111100001111111111111111111111111111111000000000000000011111111111
11111111111111111100000000000000000000000111111111111111111111111111111111111111111111111111111111111110000000000000011111111111111
11111111111111111100000000000000000000001111111111111111111111111111111111111111111111111111111110000000000000000000111111111111111
11111111111111111111000000000000000000001111111111111111111111111111111111111111111111111111111100000000000000000000111111111111111
11111111111111111111100000000000000000111111111111111111111111111111111111111111111111111111111100000000000000000000111111111111111
11111111111111111111111000000000000011111111111111111111111111111111111111111111111111111111111100000000000000000011111111111111111
11111111111111111111111111111111111111111111111111111111111111111111111111111111111111111111111100000000000000001111111111111111111
11111111111111111111111111111111111111111111111111111111111111111111111111111111111111111111111111000000000000011111111111111111111
11111111111111111111111111111111111111111111111111111111111111111111111111111111111111111111111111111111111111111111111111111111111
11111111111111111111111111111111111111111111111111111111111111111111111111111111111111111111111111111111111111111111111111111111111
11111111111111111111111111111111111111111111111111111111111111111111111111111111111111111111111111111111111111111111111111111111111

