11111111100000000000000000000000000000001111111000000000000000000001111111111111111111111111111111111111111111111111111111111111111
11111111110000000000000000000000000000001111111000000000000000000001111111111111111111111111111111111111111111111111111111111111111
11111111111000000000001110000000000000000111110000000000000000000001111111111111111111111111111111111111111111111111111111111111111
11111111111100000000001110000000000000000011100000000000000000000001111111111111111111111111111111111111111111111111111111111111111
11111111111100000000000100000000000000000001000000000000000000000001111111111111111111111111111111111111111111111111111111111111111
11111111111111100000000000000000000001100000000000000000000000000001111111111111111111111111111111111111111111111111111111111111111
11111111111111110000000000000000000001100000000000000000000000000001111111111111111111111111111111111111111111111111111111111111111
11111111111111110000000000000000000001100000000000000000000000000001111111111111111111111111111111111111111111111111111111111111111
11111111111110000000000000000000000001100000000000000000000000000001111111111111111111111111111111111111111111111111111111111111111
11111111111100000000000000000000000110011000000000000000000000000001111111111111111111111111111111111111111111111111111111111111111
11111111111000000000000000000000001001100100000000000000000000000001111111111111110000001111111111111111111111111111111111111111111
11111111110000000000000000000000000110011000000000000000000000000001111111100000110000001111111111111111111111111111111111111111111
11111111110000000000000000000000000000000000000000000000000000000011111111100000010000001111111111111111111111111111111111111111111
11111111111000000000000000000000000000000000000000000000000000000111111111100000010000001111111111111111111111111111111111111111111
11111111111110000000000000000000000000000000000000000000000001111111111111100000010000000000000000000011111111111111111111111111111
11111111111111000000000000000000000000000000000011000000000001111111111111100000000000000000000000000000000001111111111111111111111
11111111111111111000000000000000000000000000000111100000000000111111111111100000000000000000000000000000000000000000000001111111111
11111111111111111000000110001111000000000000000011000000000000011111111111100000000000000000000000000000000000000000000000011111111
11111111111111111000000111000111110000000000000000000000000000000000000000000000000011111111110000000000000000000000000111111111111
11111111111111110000001111100111111000000000000000000000000000000000000000000000000111111111111111111001011111111111111111111111111
11111111111100000000011111111111100000000000000000000011000000000000000000000000001111111111111111111111100000000000000000000000111
11111111111100000000111111111111000000000000000000000111100000000000000000000000011111111111111111111111111000000000000000000011111
11111111111110011111111111111111000000000000000000001111110000111111111111111111111111111111111111111111111000000000000000011111111
11111111111111111111111111111111111111111111111111111111111111111111111111111111111111111111111111111111100000011111111111111111111
11111111111111111111111111111111111111111111111111111111111111111111111111111111111111111111111111111111000000111111111111111111111
11111111111111111111111111111111111111111111111111111111111111111111111111111111111111111111111111111110000000111111111111111111111
11111111111111111111111111111111111111111111111111111111111111111111111111111111111111111111111100000000000000000000111111111111111
11111111111111111111111111111111111111111111111111111111111111111111111111111111111111111111111100000000000000000000111111111111111
11111111111111111111111111111111111111111111111111111111111111111111111111111111111111111111111100000000000000000000111111111111111
11111111111111111111111111111111111111111111111111111111111111111111111111111111111111111111111100000000000000000000111111111111111
11111111111111111111111111111111111111111111111111111111111111111111111111111111111111111111111100000000000000000000111111111111111
11111111111111111111111111111111111111111111111111111111111111111111111111111111111111111111111100000000000000000000111111111111111
11111111111111111111111111111111111111111111111111111111111111111111111111111111111111111111111111111111111111111111111111111111111
11111111111111111111111111111111111111111111111111111111111111111111111111111111111111111111111111111111111111111111111111111111111
11111111111111111111111111111111111111111111111111111111111111111111111111111111111111111111111111111111111111111111111111111111111

