22222222230000000000000000000000000000000000000000000000000000000000000000000000000000000000000000000000000000000000000000000000000
11111111140000000000000000000000000000000000000000000000000000000000000000000000000000000000000000000000000000000000000000000000008
11111111113000000000000000000000000000000000000000000000000000000000000000000000000000000000000000000000000000000000000000000000091
11111111111300000000000000000000000000000000000000000000000000000000000000000000000000000000000000000000000000000000000000000008211
11111111111400000000000000000000000000000000000000000000000000000000000000000000000000000000000000000000000000000000000000000000811
11111111111122300000000000000000000000000000000000000000000000000000000000000000000000000000000000000000000000000000000000000922111
11111111111111130000000000000000000000000000000000000000000000000000000000000000000000000000000000000000000000000000000009222111111
11111111111116650000000000000000000000000000000000000000000000000000000922222222222222222300000000000000000000009222222221111111111
11111111111150000000000000000000000000000000000000000000000000000000092111111111111111111122300000092222222222221111111111111111111
11111111111500000000000000000000000000000000000000000000000000000009211111111111116666111111123000911111111111111111111111111111111
11111111115000000000000000000000000000000000000000000000000000000008111111111666650000711111111230811111111111111111111111111111111
11111111140000000000000000000000000000000000000000000000000000000008111111115000000000071111111112111111111111111111111111111111111
11111111140000000000000000000000000000000000000000000000000000000091111111150000000000008111111111111111111111111111111111111111111
11111111113000000000000000000000000000000000000000000000000000000911111111400000000000007666666666666611111111111111111111111111111
11111111140000000000000000000000000000000000000000000000000009222111111111400000000000000000000000000076666661111111111111111111111
11111111113000000000000000000000000000000000000000000000000007111111111111400000000000000000000000000000000007666666666661111111111
11111166665000000000000000000000000000000000000000000000000000711111111666500000000000000000000000000000000000000000000007611111111
11111400000000000000000000000000000000000000000000000000000000076666665000000000000000000000000000000000000000000000000000071111111
11111130000000000000000000000000000000000000000000000000000000000000000000000000000092230000000000000000000000000000000000008111111
11111140000000000000009222300000000000000000000000000000000000000000000000000000000911113000000000000000000000000000000000007666111
11400000000000000000091111122222300000000000000000000093000000000000000000000000009111111222222300000000000000000000000000000000211
11400000000000000000911111111114000000000000000000000911300000000000000000000000091111111111111122222222223000000000000000000092111
11130000000000000000766666666665000000000000000000009111130000000000000000000009211111111111111111111111115000000000000000092211111
11140000000000000000000000000000000000000000922222221111112222230000000000009221111111111111111111111111500000000000000009211111111
11111300000000000000000000000000000000000000811111111111111111112222300009221111111111111111111111111115000000000000000091111111111
11111122222222222300000000000000000000000922111111111111111111111111122221111111111111111111111116666650000000000000092211111111111
11111111111111111400000000000000000000009111111111111111111111111111111111111111111111111111111150000000000000000000911111111111111
11111111111111111123000000000000000000008111111111111111111111111111111111111111111111111111111400000000000000000000811111111111111
11111111111111111110300000000000000000921111111111111111111111111111111111111111111111111111111400000000000000000000811111111111111
11111111111111111111123000000000000092111111111111111111111111111111111111111111111111111111111400000000000000000092111111111111111
11111111111111111111111222222222222211111111111111111111111111111111111111111111111111111111111400000000000000009211111111111111111
11111111111111111111111111111111111111111111111111111111111111111111111111111111111111111111111123000000000000091111111111111111111
11111111111111111111111111111111111111111111111111111111111111111111111111111111111111111111111111222222222222211111111111111111111
11111111111111111111111111111111111111111111111111111111111111111111111111111111111111111111111111111111111111111111111111111111111
11111111111111111111111111111111111111111111111111111111111111111111111111111111111111111111111111111111111111111111111111111111111

