11111111100000000000000000000000000000001111111000000000000000000000000000000000000000000000000000000000000000000000000000000000000
11111111110000000000000000000000000000001111111000000000000000000000000000000000000000000000000000000000000000000000000000000000000
11111111111000000000000000000000000000000111110000000000000000000000000000000000000000000000000000000000000000000000000000000000000
11111111111100000000000000000000000000000011100000000000000000000000000000000000000000000000000000000000000000000000000000000000000
11111111111100000000000000000000000000000001000000000000000000000000000000000000000000000000000000000000000000000000000000000000000
11111111111111100000000000000000000000000000000000000000000000000000000000000000000000000000000000000000000000000000000000000000000
11111111111111110000000000000000000000000000000000000000000000000000000000000000000000000000000000000000000000000000000000000000000
11111111111111110000000000000000000000000000000000000000000000000000000000000000000000000000000000000000000000000000000000000000000
11111111111110000000000000000000000000000000000000000000000000000000000000000000000000000000000000000000000000000000000000000011111
11111111111100000000000000011111111111111111111111111111111111111111111111111111111111111111111110000000000000000000000000001111111
11111111111000000000000001111111111111111111111111111111111111111111111111111111111111111111111111111100000000000000000000000001111
11111111110000000000000000011111111111111111111111111111111111111111111111111111111111111111111111111111110000000000000000111111111
11111111110000000000000000000000000000000000000000000000000000000000000000000000000000000000000000000000000000000000000000111111111
11111111111000000000000000000000000000000000000000000000000000000000000000000000000000000000000000000000000000000000000000011111111
11111111111110000000000000000000000000000000000000000000000000000000000000000000000000000000000000000000000000000000000001111111111
11111111111111000000000000000000000000000000000000000000000000000000000000000000000000000000000000000000000000000000001111111111111
11111111111111111000000000000000000000000000000000000000000000000000000000000000000000000000000000000000000000000000000001111111111
11111111111111111000000000000000000000000000000000000000000000000000000000000000000000000000000000000000000000000000000000011111111
11111111111111111111111111000000000000000000000000000000000000000000000000000000000000000000000000000000000000000000000111111111111
11111111111111111111111111100000000000000000000000000000000000000000000000000000000000000000000000000001011111111111111111111111111
11111111111111111111111111111111100000000000000000000011000000000000000000000000000011111111111111111111111111111111111111111111111
11111111111111111111111111111111111111111111111111111111111111111111111111111111111111111111111111111111111111111111111111111111111
11111111111111111111111111111111111111111111111111111111111111111111111111111111111111111111111111111111111111111111111111111111111
11111111111111111000000000000000000000000000000000000000000000000000000000000000000000000000000000000000001111111111111111111111111
11111111111111110000000000000000000000000000000000000000000000000000000000000000000000000000000000000000000000111111111111111111111
11111111111111000000000000000000000000000000000000000000000000000000000000000000000000000000000000000000000000111111111111111111111
11111111111000000000000000000000000000000000000000000000000000000000000000000000000000000000000000000000000000000111111111111111111
11111111100000000000000000000000000000000000000000000000000000000000000000000000000000000000000000000000000000000001111111111111111
11111111100000000000000000000000000000000000000000000000000000000000000000000000000000000000000000000000000000000000111111111111111
11111111000000000000000000000000000000000000000000000000000000000000000000000000000000000000000000000000000000000000111111111111111
11111111000000000000000000000000000000000000000000000000000000000000000000000000000000000000000000000000000000000000111111111111111
11111111000000000000000000000000000001000000000000000000001000000000000000000100000000000000000000000000000000000000111111111111111
11111111000000000000000000000000000011100000000000000000011100000000000000001110000000000000000000000000000000000001111111111111111
11111111000000000000000000000000000011100000000000000000011100000000000000001110000000000000000000000000000000000001111111111111111
11111111000000000000000000000000000111110000000000000000111110000000000000011111000000000000000000000000000000000001111111111111111

