100000000000000000000000000000001111111000000000000000000001
110000000000000000000000000000001111111000000000000000000001
111000000000001110000000000000000111110000000000000000000001
111100000000001110000000000000000011100000000000000000000001
111100000000000100000000000000000001000000000000000000000001
111111100000000000000000000000000000000000000000000000000001
111111110000000000000000000000000000000000000000000000000001
111111110000000000000000000000000000000000000000000000000001
111110000000000000000000000000000000000000000000000000000001
111100000000000000000000000000000000000000000000000000000001
111000000000000000000000000000000000000000000000000000000001
110000000000000000000000000000000000000000000000000000000001
110000000000000000000000000000000000000000000000000000000011
111000000000000000000000000000000000000000000000000000000111
111110000000000000000000000000000000000000000000000001111111
111111000000000000000000000000000000000011000000000001111111
111111111000000000000000000000000000000111100000000000111111
111111111000000110001111000000000000000011000000000000011111
111111111000000111000111110000000000000000000000000000000000
111111110000001111100111111000000000000000000000000000000000
111100000000011111111111100000000000000000000011000000000011
111100000000111111111111000000000000000000000111100000001111
111110011111111111111111000000000000000000001111110000111111
111111111111111111111111111111111111111111111111111111111111
111111111111111111111111111111111111111111111111111111111111
111111111111111111111111111111111111111111111111111111111111
111111111111111111111111111111111111111111111111111111111111
111111111111111111111111111111111111111111111111111111111111
111111111111111111111111111111111111111111111111111111111111
111111111111111111111111111111111111111111111111111111111111
111111111111111111111111111111111111111111111111111111111111
111111111111111111111111111111111111111111111111111111111111
111111111111111111111111111111111111111111111111111111111111
111111111111111111111111111111111111111111111111111111111111
111111111111111111111111111111111111111111111111111111111111
111111111111111111111111111111111111111111111111111111111111
111111111111111111111111111111111111111111111111111111111111
111111111111111111111111111111111111111111111111111111111111
